01 세상에서 가장 위험한 파충류들
으악, 위험한 파충류가 나타났다!
무시무시한 우산 목 : 코브라
죽음의 키스 : 블랙맘바
완벽한 무장 갑옷 : 코모도왕도마뱀
고요한 물속의 괴물 : 나일악어
몽땅 삼켜 버리는 입 : 그물무늬비단뱀
바다의 치명적인 독 : 바다뱀
세상에서 가장 사나운 뱀 : 인랜드타이판
섬뜩한 공격 : 미국악어
잠복의 대가 : 악어거북
공포스러운 접근 : 톱비늘북살무사
또 다른 치명적인 파충류들
파충류의 특징

02 세상에서 가장 교활한 파충류들
으악, 교활한 파충류가 나타났다!
물 위의 달리기 선수 : 바실리스크도마뱀
날아다니는 파충류 : 날도마뱀
꼬리 속임수의 대가 : 나뭇잎꼬리도마뱀붙이
색깔 변신술 : 카멜레온
최고의 사기꾼 : 사막뿔살무사
똑똑한 꼬리 : 다섯줄도마뱀
냄새 나는 등껍질 : 사향거북
흉내 내기의 달인 : 이스턴밀크스네이크
물속의 청소기 : 마타마타거북
마법의 발가락 : 집도마뱀붙이
또 다른 영리한 파충류들
파충류에 관한 놀라운 사실

03 세상에서 가장 거대한 파충류들
으악, 거대한 파충류가 나타났다!
커다란 대양 순둥이 :장수거북
거대한 무적의 갑옷 :갈라파고스코끼리거북
바다의 방랑자 :바다악어
가장 강력한 힘 :그린아나콘다
무시무시한 독니 :가분살무사
숲속의 귀염둥이 :코뿔이구아나
나무타기 선수 : 토케이게코
사막의 폭군 : 길라몬스터
뱀을 먹는 뱀 : 킹코브라
짤랑짤랑 소리의 비밀 : 다이아몬드백방울뱀
세상에서 가장 작은 파충류들
지금은 멸종된 거대 파충류들

04 세상에서 가장 이상한 파충류들
으악, 이상한 파충류가 나타났다!
근사한 목도리 장식 : 목도리도마뱀
지렁이일까, 뱀일까? : 지렁이도마뱀
살아 있는 화석 : 투아타라
모두가 암컷 : 뉴멕시코채찍꼬리도마뱀
사막의 뾰족한 악마 : 가시도마뱀
눈에서 피를 내뿜는 도마뱀 : 뿔도마뱀
바다를 사랑하는 파충류 : 바다이구아나
물고기 사냥꾼 : 가비알
말랑말랑한 등껍질 : 자라
나미브의 이상한 도마뱀 : 나미브물갈퀴도마뱀붙이
또 다른 신기한 파충류들
이상한 공룡들

실루엣 퀴즈 : 나는 누구일까요?
INDEX : 파충류 찾아보기