들어가는 글
1장. 그리다
손동현: 이미지 시대의 미메시스
안지산: 만지는 것과 보이는 것
이희준: 추상을 통한 회화 탐구
지희킴: 형상과 색의 향연
2장. 조각하다
권오상: 조각을 위한 조각
정소영: 지질학적 사유
최태훈: 사물과 조각을 지각하기
3장. 반영하다
옥승철: 이미지 흐름의 시원
장재록: 동시대적 한국화의 실현
정고요나: SNS 시대의 회화
4장. 경계 위에 서다
노상호: 온라인과 오프라인
돈선필: 조각가보다는 원형사처럼
이동기: 이미지의 별자리
5장. 질문하다
민예은: 끝없이 채우는 경우의 수
신제현: 철학하기에 가까운 프로젝트
이정형: 모호한 오브제, 모호한 공간
6장. 이야기하다
서인혜: 삶의 시간 전하기
이경미: 내러티브의 확산
이진주: 기억과 망각의 변주
장종완: 블랙코미디의 세계
7장. 존재를 생각하다
신미경: 번역된 메멘토 모리
심래정: 재미있고 무서운 세계
최우람: 인간에 대한 성찰
참고문헌