여는 글 1, 2
〈아이와 떠나는 제주 여행 버킷 리스트〉 활용법
한눈에 보는 제주 여행 지도

명소편
카멜리아힐 - 동백꽃 향기에 흠뻑 빠질 수 있는 곳
성산일출봉 - 제주도의 뛰어난 경관을 볼 수 있는 곳
산굼부리 - 제주도에서 가장 아름다운 가을 억새
절물자연휴양림 - 가슴 깊은 곳까지 맑은 공기를 느껴요·
하귀애월 · 신창풍차 · 해맞이 해안도로 - 가족과 함께 해안도로를 달려요
휴애리 자연생활공원 - 계절별로 꽃 축제가 유명한 테마파크
광치기 해변 · 표선면 가시리 · 산방산 - 제주도 봄날의 수채화, 유채꽃밭
구엄리 돌염전 - 제주도 사람들은 어떻게 소금을 얻었을까?
종달리 수국길 - 여름을 알리는 제주도의 선물
한라 수목원 - 도심 속의 수목원, 조용한 숲길을 걸어요
한림공원 - 열대지방의 나무가 모두 모여 있는 곳
여미지 식물원 - 기네스북에 오른 동양 최대의 온실 식물원
4.3평화공원 - 아이의 눈높이로 제주의 아픈 역사를 이야기해요
비자숲힐링센터 - 친환경 체험으로 아이와 힐링을 하자
새연교 - 야경이 예쁜 다리를 아이와 함께 산책해요
에코랜드 - 제주도에서 기차 타고 숲을 여행해요
명월국민학교 - 폐교가 아름다운 문화공간으로 거듭나다
액티브파크 제주 - 사계절 실내에서 클라이밍을 즐겨요
오설록 티 뮤지엄 - 국내 최초의 차 박물관이자 문화공간
무민랜드 - 무민 이야기가 가득 채워진 감성 공간
스누피 가든 - 따듯함이 가득한 야외 정원과 전시관
제주민속촌 - 조선 시대 속 제주 마을로의 여행
화조원 - 예쁜 새들과 친구가 되어요
더마파크 - 제주도에서는 말도 연기를 한다
신비의 도로 - 어라, 저절로 공이 위로 올라가네?

체험편
감귤 따기 체험 - 새콤달콤한 귤을 수확해 보자
제주도 보말 채집 - 제주도의 보물, 보말을 잡아요
우당 도서관 - 아름다운 뷰가 있는 제주도의 도서관
동문재래시장 · 매일올레시장 - 아이와 제주 전통 시장을 찾아가요
계절별 제주 추천 호텔 - 아이와 함께 호캉스를 만끽하자
도치돌 알파카 목장 - 귀여운 알파카를 찾아서!
북타임 - 아이와 함께 제주도 책방 투어
노루생태관찰원 - 가볍게 트레킹을 하며 노루를 만날 수 있는 곳
아침미소목장 - 탁 트인 풍경을 자랑하는 제주도의 스위스
제주해바라기공방 - 제주의 바다를 나만의 작품 속에 담아요
캔디원 - 사탕 향기가 솔솔, 하루가 달콤해지는 체험
아토도예공방 - 나만의 접시를 만들 수 있는 곳
노지 캠핑 - 캠핑의 천국 제주도 1
오토 캠핑 - 캠핑의 천국 제주도 2
비밀의 숲 - 동화 같은 숲을 산책할 수 있는 곳
하효살롱협동조합 - 제주도의 맛, 감귤 타르트 만들기
산방산 탄산온천 - 제주도의 신기한 탄산온천 체험
차귀도 요트 투어 - 럭셔리하게 제주 바다를 즐기는 방법
제주 승마공원 - 제주도에서 즐기는 승마 체험
서핑 체험 - 시원한 바다에서 아이와 함께 서핑을
당근 체험 - 아이부터 어른까지 수확의 기쁨을 느껴 봐요
제주대학교 벚꽃길 - 전국에서 가장 먼저 벚꽃이 피는 곳
서귀포 잠수함 - 수심 40m까지 볼 수 있는 특별한 경험
차귀도 낚시 체험 - 초보자도 손맛을 느낄 수 있어요
모슬포항과 대방어 축제 - 대방어의 쫄깃함을 맛볼 수 있는 곳

자연편
사려니숲 - 피톤치드를 가슴 깊숙하게 마셔요
용두암 · 도두동 무지개해안도로 - 제주 바다에서 용을 만나다
큰엉해안경승지 - 나무 사이에 그려진 한반도 지도
성산일출봉 · 거문오름 - 유네스코 세계 자연유산의 현장으로
아이와 함께 가기 좋은 오름 10곳 - 아이와 함께 오름에 올라요
섭지코지 - 제주도 동쪽 바다를 한눈에 바라보자
돈내코 유원지 - 물놀이하기 좋은 제주도의 계곡
쇠소깍 - 제주 전통 배를 타고 쇠소깍을 구경해요
표선해수욕장 · 이호테우해수욕장 - 아이와 물놀이하기 안전한 해수욕장
정방폭포 - 서귀포 지명의 유래가 담긴 곳
천지연폭포 - 폭포가 쏟아지는 공원에서 하루를
천제연폭포 - 예술품 같은 세 개의 폭포가 모여 있는 곳
우도 - 섬 속의 섬, 아름다운 우도 여행
가파도 - 드넓은 청보리밭이 아름다운 섬
비양도 - 비양나무를 볼 수 있는 유일한 곳
마라도 - 우리나라 최남단의 섬으로 떠나 보자
1100고지 습지 - 차를 타고 한라산에 올라요
한담해안산책로 - 아이와 함께 걷기 좋은 해안산책로
월정리 바다 - 해외여행을 온 듯한 에메랄드빛 바다
색달해수욕장 - 하와이의 와이키키 해변이 제주도에
성이시돌목장 - 척박한 땅에서 일궈 낸 거대한 초원
송악산 - 걷기 좋은 둘레길이 있는 곳
안덕계곡 - 사시사철 물이 흐르는 유일한 제주도 계곡
어영공원 - 대한민국 최고의 바다 뷰 놀이터
만장굴 - 동양 최대의 용암 동굴

박물관편
제주 돌문화공원 - 제주도를 이해할 수 있는 테마파크
감귤박물관 - 제주도 하면 감귤, 감귤 하면 제주도
이중섭 미술관 - 불운의 천재 화가, 이중섭을 찾아가다
왈종미술관 - 미술관 전체가 하나의 예술 작품인 곳
김영갑 갤러리 두모악 - 제주도를 사랑한 사진작가 김영갑을 찾아서
아르떼뮤지엄 제주 - 빛으로 그린 아름다운 예술 작품
국립제주박물관 - 모든 제주의 역사를 만날 수 있는 곳
해녀 박물관 - 유네스코 인류무형문화유산 해녀를 찾아서
피규어 뮤지엄 - 아이보다 어른이 더 좋아하는 박물관
헬로키티 아일랜드 - 온통 핑크빛으로 물든 세상
넥슨 컴퓨터 박물관 - 제주도에서 컴퓨터의 역사를 배워요
제주 항공우주 박물관 - 제주도를 넘어 세계로, 우주로!
아쿠아플라넷 제주 - 아시아 최대 면적을 자랑하는 아쿠아리움
박물관은 살아있다 - 어른도, 아이도 동심의 세계로 떠나요
별빛누리공원 - 제주에서 우주 과학자의 꿈을 키워요
아프리카 박물관 - 제주도에서 아프리카 문화를 배워요
더 플래닛 - 버디프렌즈가 들려주는 숲속 이야기
세계 자동차&피아노 박물관 - 아이를 위한, 어른을 위한 박물관
제주민속자연사박물관 - 제주의 역사와 전통문화가 숨 쉬는 공간
삼성혈 - 탐라왕국의 발상지를 찾아서
추사관 - 추사 선생님의 묵향이 있는 곳
제주목 관아 · 관덕정 - 옛 제주의 중심을 찾아서·
제주 유리박물관 - 아름다운 유리 공예를 만날 수 있는 곳
테디베어 박물관 - 귀여운 테디베어로 가득한 세상
브릭캠퍼스 - 아이들의 친구 레고와 하루를

부록 1 한달살이
부록 2 일년살이