프롤로그_사람이 있다

1. 겨울 왕국에서 온 초대장, 북유럽
바이킹으로 시작된 북유럽 역사
북유럽 신화가 알려주는 삶의 환희
개인의 소소한 행복이 중요한 북유럽풍 문화

2.산란하는 빛을 담다, 스웨덴
일상을 노래한 투명 수채화 | 칼 라르손
매혹적인 빛의 물결 | 안데르스 소른
일상에 재현한 천국 | 요한 프레드릭 그루텐
일상을 벗어난 고요함 | 구스타프 피에스타드
행복과 불행 사이 | 리카르드 베르그
빛에 어우러진 일상의 행복 | 비고 요한센
행복한 빛의 향연 | 한나 파울리
화려함 뒤 일상의 소중함 | 칼 스콘베르그
북유럽 둘러보기-스웨덴

3. 피오르의 대자연을 담다, 노르웨이
메멘토 모리 | 에드바르 뭉크
압도적인 자연의 향연 | 한스 프레드릭 구데
끝없는 우주의 숭고함 | 하랄드 솔베르그
행복과 불행은 함께 있다 | 하리에트 바케르
다른 사람을 사랑하면 신을 만나게 된다. | 크리스티안 크로그
걸으면 해결된다 | 한스 달
대자연의 경이로움 | 크리스티안 달
무위의 행복감 | 페데르 발세
빛이 주는 포근함 | 프리츠 타우로프
신비와 낭만의 동화 세계 | 테오도르 키틸센
장엄한 풍경과 비장한 슬픔 | 에일리프 페테르센
북유럽 둘러보기-노르웨이

4. 고요히 스며드는 일상을 담다, 덴마크
일상의 행복을 보여주는 빛 1 | 빌헬름 함메르쇠이
일상의 행복을 보여주는 빛 2 | 칼 빌헬름 홀소에
행복의 일상을 보여주는 빛 3 | 페테르 일스테드
운명의 두 그림자 | 페데르 세베린 크뢰위에르
빛에 어우러진 일상의 행복 | 비고 요한센
일상의 숭고함 | 안나 앙케르
불안에 대한 위로와 희망 | 크리스텐 쾌브케
북구의 파리 코펜하겐의 일상 | 폴 구스타프 피셔
빛의 아우라 | 베르타 베그만
일상에 숨겨진 영원한 아름다움 | 라우리츠 안데르센 링
달콤한 게으름 | 페테르 한센
관점을 바꾸면 일상이 달라진다 | 빌헤름 에커스버그
진짜와 가짜 | CN 헤이스브레흐트
북유럽 둘러보기-덴마크

5. 단순하지만 분명한 행복을 담다, 핀란드
일상의 행복한 친구 | 알베르트 에델펠트
나는 나로서 행복하다 | 엘린 다니엘손 감보기
현재를 사랑하라 | 후고 심베리
영혼의 동반자 | 헬레나 베스테르마르크
빨간색과 노란색이 필요한 이유 | 헬렌 세르프백
허위와 진짜의 아름다움 | 에로 자르네펠트
나를 사랑하는 순간 | 페카 할로넨
자연으로부터 받은 진실 | 빅토르 베르테르홀름
생생하고 풍부한 일상 | 군나르 베르트손
슬픈 영혼에 대한 위로 | 악셀리 갈렌칼렐라
북유럽 둘러보기_핀란드