● 동화 속 풍경 소도시 여행
알베로벨로 - 폴리아의 동화 마을
갈리폴리 - 이오니아 해의 진주
마테라 - 세상 어디에도 없는 곳
레체 - 두 얼굴의 도시
포시타노 - 꿈의 도시
소렌토와 아말피 - 세이렌의 노랫소리에 홀리는 곳
라벨로 - 우아한 선율이 흐르는 공중 정원

● 시칠리아 소도시 여행
타오르미나 - 시칠리아의 파라다이스
카타니아 - 화산의 도시
아그리젠토 - 신전의 계곡
에리체 - 비너스의 키스
팔레르모 - 시칠리아 문명의 기억

● 슬로푸드 소도시 여행
페루자 - 움브리아의 부엌
스펠로 - 세상의 중심
피렌체 - 화려하지 않은 행복
시에나 - 판포르테의 달콤함
볼로냐 - 이탈리아 미식의 수도

● 숨은 자연 소도시 여행
베로나 - 로맨스가 피어나는 곳
코모 - 비단결 같은 호수 한 바퀴
베르가모 - 천상의 도시
볼차노 - 오스트리아의 향기
알페 디 시우시 - 돌로미테의 초록 심장
아오스타 - 이탈리아의 알프스

● 꿈의 해안 소도시 여행
베네치아 - 물의 도시
부라노 - 마법 같은 행복
트리에스테 - 제임스 조이스의 피난처
트로페아 - 칼라브리아의 숨겨진 보물
친퀘 테레 - 사랑의 길

● 세계 문화유산 소도시 여행
아시시 - 순례자의 도시
산 지미냐노 - 마천루의 도시
피사 - 기적의 들판
라벤나 - 비잔틴 모자이크의 도시