들어가며
홈그라운드 목욕탕 - 고스기유(도쿄 고엔지)
대중목욕탕 가격·준비물
대중목욕탕 이용법

제1장. 초심자 코스 “목욕탕 첫걸음”
목욕탕 본연의 모습을 간직한 곳 - 다이코쿠유(도쿄 기타센주)
친구랑 가고 싶은 목욕탕 - 우메노유(도쿄 아라카와)
최고의 품질을 추구한다 - 닛포리 사이토유(도쿄 닛포리)
목욕탕 테마파크 - 히다마리노 이즈미 하기노유(도쿄 우구이스다니)
밥맛이 좋아지는 목욕탕 - 도고시 긴자 온천(도쿄 도고시 긴자)
노천탕 하면 여기지! - 다이코쿠유(도쿄 오시아게)
매번 새로워지는 변혁의 목욕탕 - 기라쿠유(사이타마 가와구치)
Column 1. 목욕탕 도감 그리는 법

제2장. 상급자 코스 “목욕탕을 즐기다”
현대 목욕탕 건축의 걸작 - 오쿠라유(도쿄 마치다)
목욕탕 건축의 새로운 물결 - 천연온천 히사마츠유(도쿄 네리마)
벚꽃놀이 목욕탕 - 사쿠라칸(도쿄 가마타)
제대로 호강하는 목욕탕 - 천연온천 유돈부리 사카에유(도쿄 니혼즈쓰미)
도심 속의 오아시스 - 유가 와고코로 요시노유(도쿄 나리타히가시)
교토에 몸을 담그다 - 사우나 우메유(교토)
마니아들이 사랑하는 온천 - 쇼와 레트로 온천 이치노유(미에 이가)
Column 2. 냉온욕을 해보세요

제3장. 마스터 코스 “궁극의 목욕탕”
즐길 거리가 넘쳐나는 목욕탕 - 야쿠시유(도쿄 스미다)
과거로 떠나는 시간여행 - 가마타 온천(도쿄 가마타)
울고 싶을 때 찾아가는 목욕탕 - 교난욕장(도쿄 무사시사카이)
그곳에 가면 별천지가 있다 - 다이코쿠유(도쿄 요요기우에하라)
목욕탕계의 지상낙원 - 구아팔레스(지바 나라시노)
Column 3. 대중목욕탕 커뮤니티
제4장. 인간미 코스 “목욕탕 사람들”
애정이 듬뿍 들어간 목욕탕 - 헤이덴 온천(아이치 나고야)
너구리 전투가 펼쳐지는 목욕탕 - 쇼와유(도쿠시마)
고향집에 온 것 같은 목욕탕 - 곤파루유(도쿄 오사키)

마치며
나의 첫 목욕탕 도감 - 고토부키유(도쿄 히가시우에노)
목욕탕 리스트