들어가며 | 단연코 세상에서 가장 재미있는 역사, 의학의 역사

1장 열정과 섬뜩 사이에서 의학 발달사
해부 | 고대 그리스의 해부가 악마의 지식으로 불린 이유
사망진단 | 선조들이 삼일장을 치른 이유
손 씻기 | 오스트리아 빈 의과대학이 세계 최고인 이유
마취 | 맨 정신으로 수술하면 벌어지는 일
수술 장갑 | 세상에서 가장 로맨틱한 발명품
수혈 | 혈액형을 몰랐던 의사들의 고군분투
의료 도구 | 옛날에는 무엇으로 수술했을까?
역학조사 | 19세기 상하수도가 진짜 지옥인 이유
면도 | 청동기시대부터 제모 크림으로 털을 관리한 인류
탈모 | 오 신이시여, 무엇이든 하겠나이다

2장 도전정신 하나로 이겨낸 질병 치료사
괴혈병 | 대항해시대, 건강한 선원들이 자꾸 죽어나간 이유
말라리아 | 로마제국이 망할 듯 망하지 않은 이유
치질 | 혀로 핥아도 보고 불로 지져도 봤지만
매독 | 신대륙에서 구대륙으로 건너온 성병
당뇨 | 소변에 벌레가 꼬이면 곧 죽는 병
천연두 | 최악의 전염병에도 의외로 잘 대처했던 선조들
환상통 | 3만 명의 팔다리가 잘려나간 후에야 입증된 고통
고혈압 | 혈압 측정의 쓸모를 어떻게 알았을까?

3장 남용과 무지가 낳은 약물 잔혹사
아편 | 맙소사, 아이들을 재우려고 약물을 먹였다고?
대마초 | 인류가 식량이 아닌 마약을 위해 농사를 시작했다고?
코카인 | 신의 선물인가, 악마의 속삭임인가
비소 | 많이 먹으면 죽으니까, 조금 먹어볼까?
수은 | 찰랑이는 은빛 물을 마시며 불로장생을 꿈꾼 사람들
납 | 납에서 단맛이 난다는 사실을 몰랐어야 했는데
방사능 | 만병통치약에 대한 환상이 낳은 비극들

4장 돌도끼에서 21세기 최첨단 의료 기술까지
정관수술 | 과거에도 현재에도 이곳만큼은 진심인 사람들
상처 치료 | 썩히는 것도 모자라 끓는 기름을 부었다고?
두통 치료 | 머릿속 벌레를 잡기 위해 돌로 두개골을 깐 인류
정신의학 | 로열패밀리도 평생 손쓰지 못한 일
요로결석 | 이 고통 모르는 사람은 모두 조용히 하세요
백내장 수술 | 실명하는 게 더 나은 선택지였던 시절
성형수술 | 고대 인도에서부터 시작된 회복의 역사?
지방 절제술 | 갑자기 날씬해지는 게 이렇게 위험합니다

참고문헌