[시사원정대(2024년 5월호) 목차]

[시사탐험]
커버스토리 - 미래 식탁, 우리가 접수
시간여행자의 미션 - 금관가야의 첫 여왕이 인도인인 배경을 파헤쳐라
이달의 인물 - 청각장애인 아이돌 ‘빅오션’
찬반배틀 - 발렌시아가 테이프 팔찌, 상품성 있을까?
맞춤사설 - 국민의 심판, 108대 192
맞춤기획 - 이란의 첫 이스라엘 공격, 중동 전쟁으로 번질까?
역사 만화 - 史(사)차원 김재원의 지켜라! 한국사 3

시~원한 이슈시개 - 지진, 피할 수 없다면 예측하고 대비하라

[경제탐험]
도준이의 시사 경제 일기 - 고속도로 휴게소 맛집, 4000억 원 돌파의 비결은?
핫플에 뜬 시원 - 어린이가 주인공이 되는 축제, 대한민국 어린이박람회로 GO!
경제 타임머신 - 세계를 사로잡은 검은 음료, 코카콜라 태어나다
경제 만화 - 호야의 티키타카 경제왕 3

[과학기술탐험]
똑똑 사이테크 - 진짜 텔레파시처럼 생각만으로 컴퓨터를 조작하네?
우주 만화 - 만화로 보는 우주 천문스쿨 3: 은하와 우주
자연 친구를 소개합니다 - 신라 보물의 비밀 간직한 비단벌레
환경 만화 - 라바 지구 수비대 4: 수질 오염

[문화탐험]
문화 쏙쏙 - 라이트룸 서울 전시 ‘데이비드 호크니 : 비거&클로저 낫 스몰러&퍼더 어웨이’
수상한 체험기 - 빛나는 나전칠기 공예 배우기
엔터 톡톡 - K팝 시상식의 그림자
영화 추천 - 영화 ‘혹성탈출: 새로운 시대’
음식 만화 - 달콤한 세상: 사르르, 디저트의 역사
사서의 서재 - 도시은 경남 해운초 사서선생님 | 천희선 강원 치악고 사서선생님

[미라클 본부]
생각자판기
힐링 캘리그래피
드로잉 챌린지
YO! 이것 좀 봐
스페샬 기프트
쿠키포토
귀염뽀짝 시원 포켓월드