개정판 머리말
초판 머리말

첫째 마당, 지형과 생활
호랑이의 나라 | 선조들의우리 땅에 대한 생각
백두대간인가, 태백산맥인가 | 우리 삶에 알맞은 산줄기 체계
저마다 개성 있는 암석과 산 | 우리 땅을 이루는 암석의 종류와 지형
산으로 올라가는 배 | 자유 곡류 하천과 범람원
상전벽해, 벽해상전 | 삼각주 형서이 불러오는 변화
지구를 지탱하는 작은 땅 | 습지의 가치와 중요성


여름은 열대, 겨울은 한대 | 우리나라의 대륙성 기후
삼다도의 오래된 목욕탕 | 제주도의 기후와 풍속
아는 만큼 보고, 보는 만큼 안다 | 삶을 풍요롭게 하는 지리 정보
개고기와 샤넬 NO.5 | 자연 환경과 음식 문화
비키니 입는 크리스마스 | 세계의 기후


우리나라에만 있는 지도 | 선조들의 세계관과 지도 제작 전통
김정호는 감옥에서 죽었을까 | 대동여지도와 김정호에 얽힌 이야기
조선 시대 한성의풍경 | 우리나라 전통 공간의 구조
수백 척의 배가 떠 있던 마포 | 조선 시대에 발달한 내륙 수운
우리 땅 간도와 녹둔도 | 영토 분재의 역사와 앞으로의 과제
바로 알고 지켜야 할 우리 영역 | 영토, 영해, 영공의 이해
주체적인 시간을 찾아서 | 세계의 표준시와 우리나라의 표준자오선


몸이 가까우면 마음도 가깝다 | 집과 농공업, 그리고 서비스의 입지
달농네와 타워팰리스 | 주거 지역의 분화
줄기세포와 나뭇가지 | 일제 강점기에 훼손된 우리 길
정보의 홍수를 만끽하는 법 | 정보 공간 환경의 바람직한 통제
우선 먹기는 곶감이 달다 | 성장 거점 개발과 균형 개발


빵은 부식, 고기가 주식 | 먹을거리 생산과 환경 문제
물고기 한 마리에 아이 하나 | 원주민의 생존권과 생물 다양성
해외 여행하는 애물단지 | 쓰레기 발생과 처리문제
반갑게 맞았던 갈바람 | 중국의 산업화와 우리나라
더워지는 지구 | 이상 기후 현상과 지구 온난화


편견의 그늘에서 싹트는 비극 | 부당한 차별 배후의 경제적 착취
간디와 카디 | 인도의 평화적인 민족 독립 운동
검은 것이 아름답다 | 미국의 흑인 차별 역사
집단 투우의 나라 콜롬비아 | 라틴아메리카의 혼혈 역사


무기가 된 먹을거리 | 곡물 메이저와 우리나라 농산물
세계 8대 불가사의에 도전하다 | 리비아 대수로 공사의 역군 한국인
철의 비단길을 따라서 | 시베리아의 자연 환경과 한인의 역사
지속 가능한 한류를 위해 | 한류 열풍과 세계 문화 교류

참고 문헌

삽화 자료 출처

찾아보기