● 너와 나를 배웠다
꽃 - 김춘수
낙타 - 이한직
형님전 상서 - 김사인
물로 빚어진 사람 - 김선우
긍정적인 밥 - 함민복
별들은 따뜻하다 - 정호승
우리가 물이 되어 - 강은교
사랑 - 박철
수묵 정원 9 -번짐 - 장석남
시월의 소녀 - 전봉건
공양 - 안도현
물 통(桶) - 김종삼
화살 - 고은
철길 - 김정환
사평역에서 - 곽재구


그애 - 함형수
사랑 - 정일근
사랑 - 김수영
마치……처럼 - 김민정
자두 - 이상국
그릇 1 - 오세영
바다와 나비 - 김기림
다시 첫사랑의 시절로 돌아갈 수 있다면 - 장석주
종소리 - 서정춘
라라에 관하여 - 오탁번
내 마음을 아실 이 - 김영랑
네가 그리우면 나는 울었다 -편지 10 - 고정희
전화 - 마종기
아니오 - 신동엽
칼로 사과를 먹다 - 황인숙


삼학년 - 박성우
만돌이 - 윤동주
내가 천사를 낳았다 - 이선영
아버지 수염은 지금도 자라고 있을까 - 윤재철
의자 - 이정록
성탄제 - 김종길
아배 생각 - 안상학
어머니 - 정한모
달 있는 제사 - 이용악
역 - 한성기
낙화 - 조지훈
낙화 - 이형기
인생 - 권대웅
조등 - 남진우
목계장터 - 신경림


떨어져도 튀는 공처럼 - 정현종
아직 촛불을 켤 때가 아닙니다 - 신석정
바람에게도 길이 있다 - 천상병
사랑스런 추억 - 윤동주
다리 - 고운기
첫사랑 - 고재종
겨울 바다 - 김남조
과수원 - 이수익
연필로 쓰기 - 정진규
우리들 시대의 아들아 - 홍윤숙
심경 11 -하물며 네가 떠난 뒤에야 - 이창기
눈물 - 김현승
사소한 물음들에 답함 - 송경동
겨울 강가에서 - 김경미
봄 - 이성부