프롤로그 : 관계의 스트레스, 심리학으로 풀어라

1장_관계에서 상처받지 않는 심리 법칙
타인보다 나를 먼저 사랑하라 : 착한 사람 증후군 법칙
내버려 두거나, 무조건 사랑하거나 : 내적 작동 모델의 법칙
일은 완벽하게, 관계는 허술하게 : 강박과 이완의 법칙
호의는 넘치게 베풀지 마라 : 호혜성의 법칙
꼬여 있는 사람은 꼬인 채로 두라 : 인지 타당성 평가 법칙
복수는 쓰고 용서는 달다 : 회원 재구성 법칙
자기 손을 더럽히지 않는 사람은 멀리하라 : 피해자 코스프레 법칙

2장_오해받지 않고 당당해지는 심리 법칙
타인이 나와 같기를 기대하지 마라 : 이성적 판단 오류의 법칙
나를 싫어할 거라는 생각이 외톨이를 만든다 : 자기인식과 타인인식의 법칙
성격과 행복은 불가분의 관계가 아니다 : 본성 불변의 법칙
때로는 게으른 사람이 더 행복하다 : 즉흥성과 계획성의 법칙
질투를 내 편으로 만들어라 : 샤덴프로이데 법칙
자존감이 낮을수록 의존적이 된다 : 장 독립과 장 의존의 법칙
말할 땐 멀리서, 들을 땐 밀착해서 : 집단 극화 현상 법칙
침묵은 말보다 강한 무기다 : 수동 공격 법칙

3장_애쓰지 않아도 호감을 사는 심리 법칙
사과에도 간격이 필요하다 : 사과 수용의 법칙
귀여움과 재미는 관계의 윤활유다 : 유머의 양면성 법칙
찬성만 하는 것이 공감은 아니다 : 긍정 존중의 법칙
애정이 담기지 않은 칭찬은 반감을 산다 : 자기 입증 효과의 법칙
감사는 결국 나에 대한 존중이다 : 링컨과 돼지 법칙
겸손함과 유능함은 한 끗 차이다 : 음성 인식 시스템의 법칙
인간관계에도 기본템이 있다 : SOLER 법칙

4장_무례함에 대처하는 심리 법칙
목적이 분명한 화는 관계를 개선한다 : 분노의 방패 법칙
무성의만이 오지랖을 이길 수 있다 : 조언의 부조리 법칙
무례함에는 무례함으로 대적하라 : 신뢰 효과 오류의 법칙
허세에는 무시가 최선이다 : 반사된 영광 효과의 법칙
불만의 표출은 최선을 다했을 때만 통한다 : 감정 전염의 법칙
모두에게 사랑받을 필요는 없다 : 이기적 편향의 법칙
잘 지내고 싶은 만큼만 받아줘라 : 공감 한계의 법칙

5장_집착에서 벗어나 편안해지는 심리 법칙
뇌는 타인에게 호의적이지 않다 : 통제력 착각의 법칙
관계의 경계선을 넘지 마라 : 고슴도치의 딜레마 법칙
거짓말쟁이에게 화를 내봤자 소용없다 : 리플리 증후군 법칙
꽉 막힌 사람에겐 가벼움이 답이다 : 조망 수용 능력 법칙
모든 관계는 연극과 같다 : 자기 감시와 자기 제시의 법칙
나를 지지하는 사람은 한 명으로 충분하다 : 회복 탄력성의 법칙